
EA textures/east.xpm
NO textures/north.xpm
SO textures/south.xpm
WE textures/west.xpm

F 20,20,20
C 20,27,20

111111111111
1  0       1
1          1
111111111111
10S000000001
111111111111
11         1
111111111111