EA textures/east.xpm
NO textures/north.xpm
SO textures/south.xpm
WE textures/west.xpm

F 20,20,20
C 200,200,200

11S11
10001
10001
10001
10001
10001
11001
10001
10001
10001
10001
10001
11111