EA textures/east.xpm
NO textures/north.xpm
SO textures/south.xpm
WE textures/west.xpm

F 20,20,20
C 200,200,200

11111
10N01
11111