F 255,255,255
C 10,10,10

NO textures/north.xpm
SO textures/south.xpm
WE textures/west.xpm
EA textures/east.xpm

1111111111111111111111111
100100100100100100111111111
100100100100100100
10010010010010010011
10010010000010010011111
100000000S00000000111
1000011111111000001111
111100000000000111111
1000000101010000001
1111111111111111111