F 255,255,255
C 10,10,10

NO textures/north.xpm
SO textures/south.xpm
WE textures/west.xpm
EA textures/east.xpm


11111
10N011
10011
1111111