F 40,54,24
C 244,162,97

NO textures/north.xpm
SO textures/south.xpm
WE textures/west.xpm
EA textures/east.xpm


111111111111111111111111111111111111111111111111111111111111111111111111111111111111111111111111111
101000001000000000000101010101111111000100010100010000010001111101011111010111000000101000101000001
101111101011101110000100000101010000010010111110101111101001010001010100010100111010101010101010001
100000101010001010001000011110101111101110000001010001000100001110101110101110110001000001000101001
100000000000000000000000000000000000000000000000000000000111111111111111111111111111111111111111111
1010111111111110101000000000000000000000011100000000000001
1000100000000000100000000000001100000000011100000000000011
101010111011111111101110000000000000000000000000000000011
1N100000100000000000100000000000000000000000000000000011
1000000000000000000000000000000000000000000000000000011
101000001000000000001000000000000000000000000000000011
10101010101111111000100000000000000000000000000000011
100010100010000010001000000000000000000000000000000011111111111111111111111111111111111111111111111
101000001000000000000101010101111111000100010100010000010001111101011111010111000000101000101000001
101111101011101110000100000101010000010010111110101111101001010001010100010100111010101010101010001
100000101010001010001000011110101111101110000001010001000100001110101110101110110001000001000101001
111110101111101011101111111111111111111111111111111111111111111111111111111111111111111111111111111
100000101000101000001
101111101011101111111
101000001010100000101
101011111010111110101
101010001010100010101
101110101010101010101
100000101010001010001
111111101011111011101
100000101000100010001
101110101110101110111
101000100000100010101
101011111111111010101
100010000000000010001
101010111011111111101
101000001000000000001
100000000000000000001
100000000000000000001
101000001000000000001
101010101011111110001
100010100010000010001
111110101111101011101
100000101000101000001111111111111111111111111111111111111111111111111111111111111111111111111111111
101000001000000000000101010101111111000100010100010000010001111101011111010111000000101000101000001
101111101011101110000100000101010000010010111110101111101001010001010100010100111010101010101010001
100000101010001010001000011110101111101110000001010001000100001110101110101110110001000001000101001
101111101011101111111111111111111111111111111111111111111111111111111111111111111111111111111111111
101000001010100000101
101011111010111110101
101010001010100010101
101110101010101010101
100000101010001010001
111111101011111011101
100000101000100010001
101110101110101110111
101000100000100010101
101011111111111010101
100010000000000010001
101010111011111111101
101000001000000000001
111111111111111111111
