
F 40,54,24
C 244,162,97

NO textures/bricks.xpm
SO textures/sand.xpm
WE textures/ice.xpm
EA textures/woolsnow.xpm

1111111111111111111111111111111111111111111111111111111111
1000000000000000000000000000000000000000000000000000000001
1000000000000000000000000000000000000000000000000000000001
1000000000000000000000000000000000000000000000000000000001
1000000000000000000000000000000000000000000000000000000001
1000000000000000000000000000000000000000000000000000000001
1000000000000000000000000000000000000000000000000000000001
1000000000000000000000000000000000000000000000000000000001
1000000000000000000000000000000000000000000000000000000001
1000000000000000000000000000000000000000000000000000000001
1000000000000000000000000000000000000000000000000000000001
1000000000000000000000000000000000000000000000000000000001
1000000000000000000000000000000000000000000000000000000001
1000000000000000000000000000000000000000000000000000000001
100000000000000000N000000000000000000000000000000000000001
1000000000000000000000000000000000000000000000000000000001
1000000000000000000000000000000000000000000000000000000001
1000000000000000000000000000000000000000000000000000000001
1000000000000000000000000000000000000000000000000000000001
1000000000000000000000000000000000000000000000000000000001
1000000000000000000000000000000000000000000000000000000001
1000000000000000000000000000000000000000000000000000000001
1000000000000000000000000000000000000000000000000000000001
1000000000000000000000000000000000000000000000000000000001
1000000000000000000000000000000000000000000000000000000001
1000000000000000000000000000000000000000000000000000000001
1000000000000000000000000000000000000000000000000000000001
1111111111111111111111111111111111111111111111111111111111