           F 118,30,40

NO textures/spectators1.xpm
                SO textures/spectators2.xpm
C 220,255,255
WE textures/spectators3.xpm

EA textures/spectators4.xpm


11111111111111111111111
10000000000000000000001
10000000000000000000001
10000000000000000000001
10000001111111110000001
10000001       10000001
10000001       10000001
10000001       10000001
10000001       10000001
10000001       10000001
10000001       10000001
10000001       10000001
10000001       10000001
10000001       10000001
10000001       10000001
10000001       111D1111
10000001       10000001
10000001       10000001
10000001       10000001
10000001       10000001
10000001       10000001
10000001       10000001
10000001       10000001
10000001111111110000001
10000000000000000000001
1000000000000000000N001
10000000000000000000001
11111111111111111111111
