EA textures/east.xpm
NO textures/north.xpm
SO textures/south.xpm
WE textures/west.xpm

F 20,20,20
C 200,200,200

11111
10001
10001
10001
10001
10S01
11000
10001
10001101
10001101
10001111
10001
11111