F 169,99,250
C 171,154,137

NO textures/north.xpm
SO textures/south.xpm
WE textures/west.xpm
EA textures/east.xpm

1111
100N
1111111111
